Édouard	male
François	male
Liam	male
Alexey	male
Ilya	male
Matthias	male
Tiago	male
Stanislaw	male
Piotr	male
Dolph	male
Amir	male
Christoph	male
Kellee	female
Elane	female
Idalia	female
Elana	female
Melissia	female
Danelle	female
Racheal	female
Dolores	female
Latanya	female
Erin	female
Jess	male
Donovan	male
Erik	male
Brittany	female
Bessie	female
Ester	female
Vickey	female
Noriko	female
Terence	male
Kelley	female
Eric	male
Johnna	female
Kasie	female
Christian	male
Johnny	male
Karyn	female
Hector	male
Leola	female
Opal	female
Tiny	female
Amina	female
Alfonso	male
Tina	female
Margart	female
Holley	female
Felisha	female
Marcy	female
Hank	male
Earl	male
Almeda	female
Hanh	female
Bronwyn	female
Harriette	female
Winnie	female
Hana	female
Prudence	female
Patsy	female
Leeann	female
Enda	female
Chris	male
Glady	female
Hans	male
Juliann	female
Randolph	male
Marjory	female
Hayley	female
Krystina	female
Concha	female
Hong	female
Monet	female
Eden	female
Hollie	female
May	female
Max	male
Joel	male
Cortney	female
Neal	male
Keenan	male
Verlene	female
France	female
Samatha	female
Hollis	male
Mac	male
Kyong	female
Mae	female
Mai	female
Rema	female
Brant	male
Martha	female
Tressa	female
Domenica	female
Scarlett	female
Joey	male
Rosina	female
Faith	female
Harold	male
Jayme	female
Ben	male
Norman	male
Emory	male
Eva	female
Bea	female
Florance	female
Eve	female
Bee	female
Gianna	female
Merideth	female
Vena	female
Alejandrina	female
Mireille	female
Wilbert	male
Bev	female
Kacie	female
Barney	male
Rosalie	female
Nikole	female
Antone	male
Richard	male
Tessie	female
Hortensia	female
Latisha	female
Jeanene	female
Theresia	female
Christoper	male
Lakisha	female
Keira	female
Gwenn	female
Linette	female
Tiffanie	female
Antony	male
Dovie	female
Clement	male
Shenita	female
Gladis	female
Mallie	female
Jackson	male
Thora	female
Glory	female
Toni	female
Bette	female
Kalyn	female
Marion	female
Katina	female
Edgar	male
Pierre	male
Patience	female
Lavinia	female
Mazie	female
Betty	female
Vesta	female
Gary	male
Tony	male
Genie	female
Regan	female
Wilma	female
Basilia	female
Genia	female
Warren	male
Florentina	female
Shaun	male
Merlin	male
Leighann	female
Freda	female
Merri	female
Delinda	female
Albertina	female
Mohammed	male
Albertine	female
Azzie	female
Sherwood	male
Dyan	female
Aimee	female
Dwana	female
Merry	female
Vanda	female
Katharine	female
Clelia	female
Suellen	female
Katharina	female
Carmon	female
Rita	female
Jack	male
Simona	female
Archie	male
Jamie	female
Ozie	female
Carley	female
Dwain	male
Darcy	female
Samuel	male
Delphia	female
Leon	male
Winona	female
Darline	female
Shawnna	female
Marietta	female
Gwendolyn	female
Rhoda	female
Otelia	female
Elouise	female
Beverly	female
Harriet	female
Jerrell	male
Elenora	female
Lanelle	female
Wilda	female
Marleen	female
Dixie	female
Elizbeth	female
Terri	female
Samual	male
Novella	female
Merrie	female
Nola	female
Monique	female
Sharlene	female
Terra	female
Vincenza	female
Ouida	female
Melanie	female
Richie	male
Melania	female
Terry	male
Casie	female
Ingeborg	female
Claud	male
Ellsworth	male
Vincenzo	male
Karyl	female
Donya	female
Britni	female
Cyndi	female
Nannette	female
Louis	male
Gilma	female
Emery	male
Lisabeth	female
Deloris	female
Jasper	male
Viola	female
Nakisha	female
Hedy	female
Tamatha	female
Alesha	female
Deborah	female
Louie	male
Sheridan	female
Eda	female
Jarrett	male
Mitsue	female
Sadie	female
Earle	male
Sabrina	female
Alva	male
Britany	female
Ivey	female
Leah	female
Michel	male
Ora	female
Renato	male
Lakeshia	female
Donte	male
Janis	female
Kimbra	female
Marvin	male
Owen	male
Irwin	male
Fern	female
Janie	female
Mimi	female
Tressie	female
Carmella	female
Jena	female
Gilberte	female
Jene	female
Roseann	female
Josue	male
Desire	female
Iris	female
Santos	male
Le	female
Mayme	female
Maurice	male
Maire	female
Ona	female
Candace	female
Maira	female
Sasha	female
Emma	female
Caroline	female
Kristin	female
Anita	female
Kristie	female
Stanley	male
Isaura	female
Reina	female
Sharda	female
Karan	female
Maribel	female
Neville	male
Dominque	female
Lillian	female
Deneen	female
Lilliam	female
Ophelia	female
Tawanda	female
Thaddeus	male
Nereida	female
Dorene	female
Velma	female
Wonda	female
Kennith	male
Caryl	female
Gertha	female
Caryn	female
Rashida	female
Remona	female
Akiko	female
Jefferey	male
Teri	female
Margot	female
Alaina	female
Demetrius	male
Coralie	female
Tarah	female
Jann	female
Jani	female
Velda	female
Jane	female
Soraya	female
Gisela	female
Ruth	female
Jana	female
Marylin	female
Jackelyn	female
Misty	female
Esmeralda	female
Loraine	female
Elke	female
Jonnie	female
Vernetta	female
Pansy	female
Joanne	female
Felicitas	female
Amparo	female
Ellen	female
Chelsey	female
Fredrick	male
Cinda	female
Carleen	female
Remedios	female
Raven	female
Amber	female
Freddy	male
Haywood	male
Ebonie	female
Ezequiel	male
Sam	male
Sal	male
Georgina	female
Joy	female
Lakia	female
Haley	female
Marisol	female
Armandina	female
Scarlet	female
Lucila	female
Daniel	male
Joe	male
Lucile	female
Martin	male
Jody	female
Joi	female
Jessika	female
Sau	female
Marisa	female
Susana	female
Hwa	female
Idell	female
Sheldon	male
Jay	male
Chi	male
Shona	female
Demetrice	female
Alice	female
Susann	female
Arnetta	female
Jan	female
Neva	female
Yuri	female
Aurelia	female
Valencia	female
Aurelio	male
Jae	male
Quintin	male
Reynalda	female
Shondra	female
Sonia	female
Estell	female
Margit	female
Dorine	female
Corliss	female
Petronila	female
Dacia	female
Reynaldo	male
Kiara	female
Britt	male
Zola	female
Janiece	female
Margie	female
Deena	female
Clotilde	female
Kym	female
Micki	female
Clair	male
Carolin	female
Genny	female
Corie	female
Fredericka	female
Rodger	male
Galen	male
Verona	female
Terese	female
Kelvin	male
Hulda	female
Teresa	female
Edmond	male
Betsy	female
Afton	female
Donald	male
Jonie	female
Angelita	female
Sandra	female
Cathy	female
Eugenia	female
Eugenie	female
Tijuana	female
Shari	female
Valarie	female
Vernice	female
Shara	female
Carmina	female
Selma	female
Shery	female
Rebecka	female
Andree	female
Alejandro	male
Kelsie	female
Shera	female
Guillermo	male
Cathern	female
Corrina	female
Sheri	female
Temple	female
Alejandra	female
Drucilla	female
Valeria	female
Cherelle	female
Althea	female
Jeri	female
Valerie	female
Sheryll	female
Jere	male
Nieves	female
Charis	female
Jazmin	female
Lien	female
Twanda	female
Lois	female
Bernadette	female
Ayako	female
Tanya	female
Celine	female
Weldon	male
Kellie	female
Nathaniel	male
Anitra	female
Carolynn	female
Meda	female
Syreeta	female
Loreta	female
Carolyne	female
Latarsha	female
Brittny	female
Hiram	male
Daryl	male
Anthony	male
Lara	female
Katherine	female
Mao	female
Lonna	female
Felecia	female
Kenya	female
Lacresha	female
Man	male
Kareen	female
Brittni	female
Delisa	female
Kareem	male
Asia	female
Delaine	female
Adelle	female
Bradly	male
Jule	female
Tillie	female
Chara	female
Juli	female
Aida	female
Justa	female
Aide	female
Mirta	female
Marquetta	female
Yuriko	female
Alberto	male
Berenice	female
Alberta	female
Griselda	female
Sidney	male
Mamie	female
Retta	female
Wilfredo	male
Gita	female
Paulette	female
Lane	male
Fannie	female
Pauletta	female
Justin	male
Lana	female
Noreen	female
Cordelia	female
Lani	female
Natacha	female
Daniella	female
Earnest	male
Merlene	female
Danielle	female
Emogene	female
Shaunna	female
Fiona	female
Elise	female
Marceline	female
Elisa	female
Marcelina	female
Rufina	female
Doretta	female
Patrica	female
Shin	female
Lakita	female
Jayne	female
Patrice	female
Meghan	female
Patrick	male
Liliana	female
Misha	female
Marcel	male
Raquel	female
Iona	female
Tierra	female
Sharron	female
Ione	female
Jeremy	male
Chang	male
Beth	female
Chana	female
Mellie	female
Raymond	male
Yolando	female
Kandi	female
Lora	female
Kyra	female
Irina	female
Yolanda	female
Hisako	female
Ayanna	female
Halley	female
Kandy	female
Herminia	female
Katie	female
Austin	male
Josphine	female
Cassandra	female
Jeanette	female
Ima	female
Perry	male
Jeanetta	female
August	male
Marni	female
Kaitlyn	female
Bettina	female
Cleopatra	female
Marna	female
Verla	female
Annika	female
Vella	female
Elijah	male
Jenae	female
Wilber	male
Selina	female
Elva	female
Jaclyn	female
Caitlin	female
Ayesha	female
Gertie	female
Etsuko	female
Liza	female
Kassie	female
Domenic	male
Claude	male
Gayle	female
Mittie	female
Gayla	female
Nicolle	female
Cami	female
Laine	female
Pok	female
Maureen	female
Roberto	male
Lena	female
Nikki	female
Rachal	female
Tobie	female
Sebrina	female
Phillis	female
Darby	female
Sherlyn	female
Sean	male
Jordan	male
Ginger	female
Kasandra	female
Reggie	male
Jeanie	female
Moshe	male
Ardella	female
Earnestine	female
Delora	female
Horacio	male
Cassey	female
Leonor	female
Stacia	female
Necole	female
Dick	male
Stacie	female
Carlyn	female
Nick	male
Luella	female
Sallie	female
Eldora	female
Denae	female
Kira	female
Ruthe	female
Jerilyn	female
Shantelle	female
Katy	female
Sherilyn	female
Shanda	female
Pat	female
Clarisa	female
Anika	female
Candi	female
Lasandra	female
Paz	female
Shandi	female
Buford	male
Palmira	female
Craig	male
Kati	female
Evia	female
Olinda	female
Lashaun	female
Hettie	female
Janeen	female
Kate	female
Clorinda	female
Antoinette	female
Edison	male
Saundra	female
Carolee	female
Francie	female
Sonja	female
Maddie	female
Agatha	female
Debbie	female
Marilu	female
Pablo	male
Dominick	male
Ernestine	female
Francis	male
Louetta	female
Ernestina	female
Annamaria	female
Tricia	female
Michal	male
Sheree	female
Bridgette	female
Wei	female
Dinah	female
Minta	female
Wen	female
Ozell	female
Naida	female
Eleonore	female
Tiffiny	female
Yuonne	female
Eleonora	female
Calista	female
Latashia	female
Selene	female
Luke	male
Brandon	male
Florence	female
Napoleon	male
Latosha	female
Florrie	female
Angie	female
Kiyoko	female
Alma	female
Valeri	female
Maryrose	female
Sheryl	female
Mattie	female
Sharen	female
Adele	female
Garnett	female
Dorethea	female
Laurine	female
Sharee	female
Shirley	female
Babette	female
Valery	female
Adell	female
Zachariah	male
Alexander	male
Vonnie	female
Rosella	female
Kaleigh	female
Latasha	female
Ruben	male
Rayford	male
Amal	female
Breana	female
Lida	female
Nichol	female
Berta	female
Franchesca	female
Gladys	female
Bertie	female
Ardis	female
Shala	female
Suzie	female
Mickie	female
Babara	female
Karmen	female
Carman	female
Cathie	female
Willow	female
Nakesha	female
Rochelle	female
Danae	female
Kyoko	female
Paris	male
Dorathy	female
Virgil	male
Trinity	female
Felicidad	female
Briana	female
Katrice	female
Lorena	female
Bud	male
Joye	female
Mathilde	female
Delana	female
Maxine	female
Letha	female
Sibyl	female
Geneva	female
Davina	female
Harriett	female
Farah	female
Fransisca	female
Lauryn	female
Estrella	female
Nichole	female
Darcie	female
Karin	female
Latonia	female
Nathan	male
Alessandra	female
Karie	female
Yong	female
Victor	male
Charlotte	female
Alina	female
Clemente	male
Cleora	female
Regine	female
Aline	female
Bruce	male
Delena	female
Mckenzie	female
Fritz	male
Adelaida	female
Kurt	male
Alona	female
Larissa	female
Alvera	female
Lavern	male
Jovan	female
Ilana	female
Arielle	female
Riva	female
Sharice	female
Ariel	female
Garnet	female
Priscila	female
Samara	female
Garfield	male
Patria	female
Muriel	female
Regenia	female
Tyrell	male
Clarinda	female
Nicolasa	female
Reinaldo	male
Anjelica	female
Tora	female
Jacinda	female
Chung	male
Edgardo	male
Cayla	female
Ilene	female
Sherrell	female
Chiquita	female
Naoma	female
Greg	male
Fredric	male
Lorene	female
Jadwiga	female
Naomi	female
Santina	female
Tory	male
Kam	female
Cherrie	female
Ewa	female
Verdell	female
Darrin	male
Oralee	female
Marguerite	female
Aubrey	male
Trenton	male
Corrinne	female
Tamie	female
Kathaleen	female
Delpha	female
Gale	female
Gala	female
Gwyn	female
Ngan	female
Monnie	female
Nevada	female
Agnes	female
Marianela	female
Major	male
Shirely	female
Laronda	female
Hermila	female
Larue	female
Michaela	female
Adeline	female
Blair	male
Michaele	female
Adelina	female
Maegan	female
Merle	male
Emilee	female
Xiomara	female
Tarra	female
Maryam	female
Shasta	female
Noe	male
Alysa	female
Kimberley	female
Zaida	female
Teofila	female
Sumiko	female
Sachiko	female
Renee	female
Sarah	female
Tiffaney	female
Gwen	female
Renea	female
Carie	female
Britney	female
Grayce	female
Christiane	female
Christiana	female
Jaimie	female
Carin	female
Matthew	male
Venita	female
Horace	male
Janett	female
Lou	female
Damon	male
Shizue	female
Jeanna	female
Gia	female
Thresa	female
Abbie	female
Jeanne	female
Jeanice	female
Leonore	female
Lottie	female
Leonora	female
Emelda	female
Fredda	female
Juan	male
Catrina	female
Shamika	female
Milagro	female
Tatyana	female
Noemi	female
Delores	female
Rozella	female
Rocco	male
Josefa	female
Mariella	female
Tegan	female
Ivonne	female
Vi	female
Geraldo	male
Lyndia	female
Latrina	female
Junita	female
Eneida	female
Argelia	female
Karole	female
Larraine	female
Rivka	female
Donnell	male
Heriberto	male
Wilburn	male
Ali	male
Valda	female
Seymour	male
Kittie	female
Angele	female
Howard	male
Robyn	female
Angela	female
Eliseo	male
Luvenia	female
Gertrudis	female
Kendrick	male
Tiana	female
Milissa	female
Royce	male
Nakia	female
Herma	female
Parker	male
Kandace	female
Sherril	female
Pinkie	female
Millard	male
Ethelene	female
Camila	female
Sherrie	female
Audrie	female
Roman	male
Sonya	female
Librada	female
Denna	female
Breann	female
Lester	male
Aurea	female
Thao	female
Claris	female
Beata	female
Classie	female
Regina	female
Kimberlee	female
Lurline	female
Cherryl	female
Alla	female
Sang	male
Maxwell	male
Jenine	female
Dudley	male
Christina	female
Kourtney	female
Freddie	male
Eugene	male
Charlette	female
Gwenda	female
Mabel	female
Erika	female
Catheryn	female
Judson	male
Sherita	female
Petrina	female
Jasmin	female
Corene	female
Henrietta	female
Romana	female
Lyndsey	female
Henriette	female
Veta	female
Evie	female
Alba	female
Dreama	female
Ela	female
Jeraldine	female
Mitchel	male
Joleen	female
Domonique	female
Roxanna	female
Roxanne	female
Rosann	female
Danette	female
Alexandra	female
Isiah	male
Audria	female
Lolita	female
Laticia	female
Zetta	female
Tabatha	female
Vada	female
Earleen	female
Neoma	female
Tenisha	female
Keila	female
Donella	female
Blanche	female
Milan	male
Arianna	female
Alisa	female
Phyllis	female
Daron	male
Alise	female
Lavonna	female
Louvenia	female
Annita	female
Willodean	female
Marianna	female
Marianne	female
Loyd	male
Elma	female
Lamonica	female
Carrol	female
Julieta	female
Estela	female
Neomi	female
Ashlyn	female
Darci	female
Rosalind	female
Meta	female
Mignon	female
Francoise	female
Rosalina	female
Shantel	female
Ha	female
Hortencia	female
Carlee	female
Enid	female
Kristen	female
Zackary	male
Ethel	female
Susie	female
Ardath	female
Sondra	female
Lucille	female
Donita	female
Lucilla	female
Laraine	female
Avril	female
Williemae	female
Jacelyn	female
Cameron	male
Eusebia	female
Jayson	male
Timothy	male
Gina	female
Hoyt	male
Mammie	female
Evette	female
Mary	female
Shanel	female
Samella	female
Margrett	female
Marylee	female
Kara	female
Quinton	male
Kiley	female
Khadijah	female
Suzan	female
Ofelia	female
Lavonne	female
Margene	female
Burma	female
Matt	male
Diamond	female
Hosea	male
Hien	female
Bree	female
Colton	male
Makeda	female
Kylie	female
Adelia	female
Lynette	female
Kasey	female
Myrtice	female
Aundrea	female
Deirdre	female
Ava	female
Jacki	female
Antonia	female
Sue	female
Esther	female
Esta	female
Marissa	female
Sun	female
Nell	female
Suk	female
Bonnie	female
Fabiola	female
Marjorie	female
Magda	female
Jamel	male
Aja	female
Stephen	male
Carline	female
Melba	female
Leonila	female
Jamee	female
Josiah	male
Michelle	female
Herschel	male
Isis	female
Elizabeth	female
Wilhemina	female
Edda	female
Elenor	female
Earlie	female
Jackie	female
Georgette	female
Elaina	female
Clayton	male
Gema	female
Elaine	female
Phoebe	female
Rikki	female
Mafalda	female
Clementina	female
Della	female
Celena	female
Keven	male
Clementine	female
Rena	female
Albina	female
Marget	female
Rene	male
Cora	female
Ellis	male
Casandra	female
Hortense	female
Latonya	female
Roma	female
Cori	female
Anisha	female
Heath	male
Bertha	female
Eufemia	female
Dennise	female
Ada	female
Edra	female
Cory	male
Lekisha	female
Norine	female
Carmelo	male
Jessie	female
Kathern	female
Javier	male
Jessia	female
Chloe	female
Jarod	male
Reita	female
Silvia	female
Tenesha	female
Carmela	female
William	male
Eusebio	male
Rosaline	female
Leota	female
Rochel	female
Sharita	female
Xochitl	female
Casimira	female
Carola	female
Cyndy	female
Carole	female
Jenniffer	female
Giovanna	female
Gustavo	male
Brenda	female
Polly	female
Giovanni	male
Cheryle	female
June	female
Young	female
Jung	female
Jeanelle	female
Maryanna	female
Maryanne	female
Madeleine	female
Maryellen	female
Paige	female
Earlene	female
Olympia	female
Jacquline	female
Wilbur	male
Angel	male
Marcia	female
Lavada	female
Robert	male
Lala	female
Leatha	female
Sherell	female
Lennie	female
Ciara	female
Vonda	female
Serina	female
Hermelinda	female
Raguel	female
Eboni	female
Karri	female
Marsha	female
Kenton	male
Hoa	female
Amalia	female
Etha	female
Genevieve	female
Shannan	female
Jinny	female
Troy	male
Vannessa	female
Lyndon	male
Kathlene	female
Mariela	female
Belkis	female
Shon	male
Belinda	female
Randal	male
Markita	female
Francisco	male
Concepcion	female
Maricela	female
Deeanna	female
Celeste	female
Valentina	female
Francisca	female
Celesta	female
Annabelle	female
Lanell	female
Margarito	male
Vikki	female
Garret	male
Margarite	female
Rolland	male
Margarita	female
Rodolfo	male
Vinnie	female
Theron	male
An	female
Krishna	female
Erma	female
Buffy	female
Normand	male
Lachelle	female
Ramonita	female
Jennine	female
Jesenia	female
Maude	female
Verna	female
Cathleen	female
Janine	female
Dominic	male
Barbara	female
Janina	female
Marquerite	female
Arnulfo	male
Gaylord	male
Keiko	female
Ronna	female
Sherie	female
Olga	female
Lasonya	female
Verdie	female
Maxie	female
Ronni	female
Jessenia	female
Shanta	female
Richelle	female
Paula	female
Santa	female
Shante	female
Santo	male
Francesca	female
Elena	female
Shanti	female
Forrest	male
Laila	female
Ronny	male
Teisha	female
Mauricio	male
Van	male
Hallie	female
Val	male
Renda	female
Lela	female
Zenobia	female
Coral	female
Bernarda	female
Arlette	female
Victoria	female
Danica	female
Malissa	female
Cathryn	female
Brenna	female
Lorrie	female
Venessa	female
Frieda	female
Magdalena	female
Dian	female
Becky	female
Constance	female
Arletta	female
Chantel	female
Hue	female
Clifton	male
Lashandra	female
Ronnie	male
Will	male
Alysha	female
Jamila	female
Becki	female
Tresa	female
Sherill	female
Derek	male
Maple	female
Bernice	female
Veronica	female
Anglea	female
Jannie	female
Fausto	male
Caprice	female
Bari	female
Clyde	male
Jeannetta	female
Shalanda	female
Nelly	female
Jeannette	female
Rosana	female
Frida	female
Susanne	female
Malia	female
Susanna	female
Faye	female
Gabriela	female
Isabelle	female
Jeanett	female
Inge	female
Jarred	male
Margarete	female
Inga	female
Awilda	female
Flavia	female
Maud	female
Brendan	male
Suzanne	female
Lita	female
Micha	female
Vergie	female
Suzanna	female
Clarissa	female
Tanisha	female
Catrice	female
Chun	female
Dion	male
Arnita	female
Miriam	female
Wesley	male
Teodora	female
Garry	male
Mirian	female
Crysta	female
Lesia	female
Lynelle	female
Julio	male
Shaunte	female
Paulina	female
Iliana	female
Shaunta	female
Pauline	female
Lauri	female
Julie	female
Madalyn	female
Maurine	female
Versie	female
Julia	female
Lucia	female
Concetta	female
Tyra	female
Laurie	female
Ryann	female
Arcelia	female
Therese	female
Adrien	female
Melva	female
Ina	female
Adena	female
Aleida	female
Lilla	female
Curtis	male
Nilda	female
Ilda	female
Myra	female
Melony	female
Lilli	female
Teodoro	male
Raphael	male
Vernita	female
Chandra	female
Kemberly	female
Laree	female
Lemuel	male
Asuncion	female
Kendra	female
Delma	female
Darleen	female
Cammie	female
Natasha	female
Aleshia	female
Augustina	female
Rosie	female
Odelia	female
Augustine	male
Rosia	female
Romona	female
Leida	female
Shawanna	female
Seth	male
Reyna	female
Kenisha	female
Tayna	female
Karen	female
Merlyn	female
Refugio	male
Delbert	male
Winford	male
Willia	female
Darcel	female
Refugia	female
America	female
Willie	male
Zada	female
Carissa	female
Elli	female
Renate	female
Migdalia	female
Sharon	female
Vina	female
Trista	female
Ella	female
Trula	female
Scottie	male
Asley	female
Isabel	female
Elly	female
Kenyatta	female
Harrison	male
Cherie	female
Dahlia	female
Matilde	female
Dwayne	male
Jacquelynn	female
Yajaira	female
Matilda	female
Jeni	female
Sari	female
Lavone	female
Cicely	female
Rossana	female
Sara	female
Lashanda	female
Calvin	male
Shelia	female
Agnus	female
Darryl	male
Mercedez	female
Carlotta	female
Carlie	female
Morgan	female
Mercedes	female
Marvis	female
Karine	female
Dessie	female
Christal	female
Leisha	female
Karina	female
Valorie	female
Mahalia	female
Teresia	female
Blake	male
Arica	female
Beverlee	female
Ailene	female
Sona	female
Patrina	female
Lynda	female
Edwin	male
Joellen	female
Thelma	female
Weston	male
Jennette	female
Joann	female
Era	female
Ossie	female
Denisha	female
Beverley	female
Bao	female
Keena	female
Cathey	female
Robin	female
Madelyn	female
Shyla	female
Youlanda	female
Soila	female
Oralia	female
Tashina	female
Edris	female
Dione	female
Alease	female
Darrel	male
Darren	male
Herman	male
Millicent	female
Gertrud	female
Jacquiline	female
Deja	female
Obdulia	female
Noma	female
Pasty	female
Dollie	female
Jodie	female
Sade	female
Muoi	female
Cheri	female
Whitley	female
Toby	male
Andrew	male
Yetta	female
Hae	female
Trina	female
Diedra	female
Lacy	female
Corinna	female
Diedre	female
Trinh	female
Herlinda	female
Andrea	female
Myrle	female
Ngoc	female
Shirleen	female
Usha	female
Josie	female
Angelic	female
Kenneth	male
Angelia	female
Arden	male
Hermina	female
Hillary	female
Elnora	female
Ena	female
Tinisha	female
Amanda	female
Alyssa	female
Gena	female
Dorinda	female
Kelle	female
Lia	female
Yevette	female
Kelli	female
Lin	female
Royal	male
Adaline	female
Rosaria	female
Margaret	female
Jamey	male
Calandra	female
Lesa	female
Kelly	female
Stepanie	female
Li	female
Mildred	female
Rosario	female
Noble	male
Leanne	female
Dayle	female
Krystle	female
Armida	female
Leanna	female
Margery	female
Kassandra	female
Russel	male
Imelda	female
Geri	female
Ray	male
Alyson	female
George	male
Laure	female
Colin	male
Lu	female
Anabel	female
Sherryl	female
Miranda	female
Kacey	female
Mavis	female
Georgann	female
Maritza	female
Jonell	female
Setsuko	female
Theodora	female
Porsche	female
James	male
Macie	female
Maisha	female
Waltraud	female
Magnolia	female
Lizette	female
Elsie	female
Lavelle	female
Ellie	female
Nicol	female
Tanesha	female
Penelope	female
Joeann	female
Robbie	female
Christi	female
Carolann	female
Frank	male
Kai	female
Cecile	female
Leila	female
Robbin	female
Christa	female
Fermina	female
Torrie	female
Denese	female
Nelson	male
Veda	female
Christy	female
Ivan	male
Dorothea	female
Sammy	male
Lovella	female
Latoria	female
Cecily	female
Kip	male
Khalilah	female
Rosetta	female
Dino	male
Eliza	female
Myung	female
Alissa	female
Brandie	female
Dona	female
Lisha	female
Elwood	male
Mandy	female
Chester	male
Zofia	female
Mirtha	female
Charlena	female
Cole	male
Charlene	female
Rosette	female
Lynn	female
Gerda	female
Sebastian	male
Marci	female
Stephnie	female
Preston	male
Annmarie	female
Marilou	female
Leonarda	female
Leonard	male
Jesus	male
Elida	female
Eddie	male
Erasmo	male
Palma	female
Chastity	female
Gerard	male
Emiko	female
Anne	female
Shelley	female
Towanda	female
Anna	female
Tomoko	female
Shawna	female
Madelene	female
Nida	female
Sunshine	female
Nanci	female
Allegra	female
Ralph	male
Piper	female
Rachelle	female
Rosita	female
Marguerita	female
Wanetta	female
Georgene	female
Delcie	female
Nancy	female
Omega	female
Mitzie	female
Nigel	male
Venus	female
Maida	female
Tiara	female
Emil	male
Blanch	female
Melia	female
Mari	female
Louann	female
Ruthann	female
Catherin	female
Blanca	female
Brigette	female
Kiesha	female
Lean	female
Yasmin	female
Debera	female
Ranae	female
Johnsie	female
Lynnette	female
Artie	female
Nathalie	female
Rhona	female
Alaine	female
Marline	female
Coralee	female
Walter	male
Leana	female
Matha	female
Jeana	female
Bibi	female
Vallie	female
Carrie	female
Ma	female
Tatiana	female
Ted	male
Janise	female
Felton	male
Mervin	male
Erica	female
Eloy	male
Meri	female
Phylicia	female
Somer	female
Celia	female
Andres	male
Azalee	female
Julene	female
Chelsea	female
Tommye	female
Dee	female
Ellan	female
Danyel	female
Kieth	male
Francina	female
Kayla	female
Loris	female
Vince	male
Grazyna	female
Eddy	male
Alfredo	male
Brain	male
See	female
Wendolyn	female
Shenna	female
John	male
Grace	female
Nery	female
Golda	female
Cary	male
Audra	female
Lan	female
Irma	female
Ariane	female
Laureen	female
Twila	female
Cari	female
Colette	female
Carl	male
Anastacia	female
Stasia	female
Dawn	female
Cara	female
Audry	female
Mariah	female
Tiera	female
Paulene	female
Dominique	female
Mariam	female
Marian	female
Duncan	male
Lannie	female
Jacquelyne	female
Danuta	female
Alonzo	male
Charla	female
Ching	female
Gavin	male
China	female
Marylouise	female
Lisa	female
Lise	female
Jerald	male
Deeann	female
Micaela	female
Charlie	male
Niki	female
Amiee	female
Dalene	female
Mercy	female
Clara	female
Jacquelin	female
Silvana	female
Nena	female
Karol	female
Arlinda	female
Miquel	male
Marcell	female
Lisandra	female
Basil	male
Magaret	female
Quiana	female
Marcela	female
Cris	female
Mellissa	female
Rebbeca	female
Nana	female
Leatrice	female
Twanna	female
Yanira	female
Elina	female
Annett	female
Lauran	female
Larry	male
Saturnina	female
Alvina	female
Anton	male
Nestor	male
Trinidad	female
Zulma	female
Kendal	female
Josefina	female
Jenette	female
Josefine	female
Tosha	female
Slyvia	female
Julian	male
Wendie	female
Verda	female
Danial	male
Wally	male
Kathrin	female
Micheal	male
Rosamond	female
Dominica	female
Georgetta	female
Nelia	female
Sung	male
Jacques	male
Takako	female
Nathanial	male
Zona	female
Dianne	female
Farrah	female
Joelle	female
Araceli	female
Jerrod	male
Hilary	female
Carri	female
Fairy	female
Gigi	female
Judi	female
Wilton	male
Aracely	female
Colleen	female
Sanjuana	female
Tawnya	female
Harmony	female
Kymberly	female
Quentin	male
Candis	female
Bart	male
Meryl	female
Kala	female
Corrine	female
Belle	female
Wm	male
Rhiannon	female
Mira	female
Candie	female
Barb	female
Fletcher	male
Chaya	female
Rosalia	female
Maryann	female
Vernell	female
Debora	female
Abram	male
Carisa	female
Loyce	female
Meredith	female
Tequila	female
Min	female
Carmelita	female
Vashti	female
Mia	female
Chrissy	female
Pa	female
Omar	male
Nisha	female
Amberly	female
Nichelle	female
Drema	female
Elinor	female
Alverta	female
Violeta	female
Chere	female
Hai	male
Vance	male
Leisa	female
Hal	male
Corazon	female
Han	female
Marcus	male
Joane	female
Ollie	female
Dante	male
Claretta	female
Chantelle	female
Carry	female
Tyler	male
Hailey	female
Doretha	female
Holli	female
Avelina	female
Chery	female
Carolyn	female
Freeman	male
Leigh	female
Toshia	female
Misti	female
Alfonzo	male
Yee	female
Gaye	female
Duane	male
Kristy	female
Carlton	male
Glinda	female
Krystyna	female
Mel	male
Colene	female
Sherika	female
Ross	male
Torri	female
Rudy	male
Georgiann	female
Denisse	female
Dylan	male
Ema	female
Bell	female
Coretta	female
Marry	female
Yvonne	female
Meggan	female
Georgiana	female
Edmund	male
Twyla	female
Shaunda	female
Apolonia	female
Dennis	male
Arlie	male
Toya	female
Eliana	female
Onie	female
Alene	female
Jennell	female
Hiroko	female
Buster	male
Alena	female
Kizzy	female
Dimple	female
Keva	female
Megan	female
Trevor	male
Providencia	female
Denita	female
Neida	female
Cira	female
Lina	female
Emmaline	female
Daysi	female
Olen	male
Scott	male
Esteban	male
Darla	female
Nobuko	female
Homer	male
Delia	female
Sanford	male
Elliot	male
Bobby	male
Georgianna	female
Mitzi	female
Dorthy	female
Caroll	female
Nicolette	female
Magali	female
Liberty	female
Jesica	female
Bernard	male
Dortha	female
Alvin	male
Lorenzo	male
Christena	female
Bobbi	female
Lorenza	female
Echo	female
Magaly	female
Stefany	female
Imogene	female
Rhonda	female
Winston	male
Devona	female
Sigrid	female
Arie	female
Latrice	female
Christene	female
Sandi	female
Fay	female
Jodi	female
Eartha	female
Candice	female
Vivienne	female
Lashon	female
Malinda	female
Janice	female
Edythe	female
Sandy	female
Fredia	female
Douglass	male
Israel	male
Joycelyn	female
Nadia	female
Ila	female
Cornell	male
Georgine	female
Newton	male
Daine	female
Maranda	female
Dave	male
Rachael	female
Chin	female
Pei	female
Kamilah	female
Janean	female
Shizuko	female
Shonda	female
Florene	female
Chia	female
Tona	female
Jeannine	female
Lindsay	female
Tonia	female
Lorna	female
Tonie	female
Lawerence	male
Jolyn	female
Elbert	male
Fonda	female
Caterina	female
Delicia	female
Frances	female
Inez	female
Phuong	female
Ilona	female
Ines	female
Sally	female
Dwight	male
Rick	male
Wanita	female
Wan	female
Karoline	female
Natosha	female
Milda	female
Elmer	male
Titus	male
Camelia	female
Dung	female
Marivel	female
Kindra	female
Mariko	female
Brian	male
Kimiko	female
Dotty	female
Alexis	female
Lawana	female
Lorine	female
Gregory	male
Lorina	female
Rufus	male
Savanna	female
Sanda	female
Casey	male
Mollie	female
Alia	female
Sherman	male
Barton	male
Dean	male
Jacquie	female
Eustolia	female
Valene	female
Olene	female
Jon	male
Erinn	female
Yadira	female
Odessa	female
Traci	female
Magdalen	female
Ignacio	male
Barrie	female
Billi	female
Cleotilde	female
Peggy	female
Thomasina	female
Amee	female
Dia	female
Catharine	female
Ignacia	female
Cristie	female
Rubin	male
Cristine	female
Rubie	female
Valrie	female
Zelma	female
Cristin	female
Vincent	male
Lorette	female
Ivette	female
Ladonna	female
Lola	female
Lyman	male
Maurita	female
Gricelda	female
Dionna	female
Sunday	female
Dionne	female
Ashleigh	female
Joline	female
Alica	female
Iraida	female
Jonathan	male
Carmen	female
Jarvis	male
Carmel	female
Athena	female
Shaniqua	female
Alethia	female
Kathline	female
Lessie	female
Lidia	female
Julee	female
Ute	female
Shanelle	female
Janita	female
Brook	female
Laquanda	female
Brooks	male
Jennifer	female
Jules	male
Lizabeth	female
Jennefer	female
Renata	female
My	female
In	female
Brooke	female
Laurel	female
Lauren	female
Divina	female
Jimmie	male
Nannie	female
Tristan	male
Melodie	female
Jewell	female
Aleen	female
Jerrica	female
Jannet	female
Lucretia	female
Amira	female
Collin	male
Violette	female
Kasi	female
Evelyne	female
Norma	female
Chu	female
Lorriane	female
Tu	female
Sybil	female
Rosalinda	female
Cheryl	female
Hannah	female
Vernie	female
Nan	female
Virginia	female
Tempie	female
Nam	female
Bok	female
Rosendo	male
Odette	female
Adrianne	female
Rosenda	female
Adrianna	female
Perla	female
Jodee	female
Jose	male
Wilson	male
Parthenia	female
Love	female
Tova	female
Josh	male
Helaine	female
Daina	female
Christopher	male
Shawn	male
Sydney	female
Walker	male
Keely	female
Lyn	female
Evita	female
Hellen	female
Mayola	female
Shiela	female
Niesha	female
Neil	male
Lera	female
Grant	male
Savannah	female
Nelida	female
Lauretta	female
Monte	male
Laurette	female
Raymundo	male
Cristobal	male
Cecelia	female
Bambi	female
Yesenia	female
Allen	male
Daniele	female
Janetta	female
Sharan	female
Maryland	female
Janette	female
Isreal	male
Myrna	female
Debroah	female
Roseanne	female
Desiree	female
Raymonde	female
Ezekiel	male
Terina	female
Conchita	female
Lanie	female
Majorie	female
Emerald	female
Hung	male
Emilia	female
Corine	female
Emilie	female
Tonisha	female
Andreas	male
Roxy	female
Burl	male
Renae	female
Carey	male
Jerica	female
Renay	female
Burt	male
Charmaine	female
Flo	female
Luigi	male
Anjanette	female
Caren	female
Lanny	male
Houston	male
Ceola	female
Elayne	female
Taina	female
Louise	female
Wendell	male
Annalee	female
Armanda	female
Gwyneth	female
Stephenie	female
Demetra	female
Keren	female
Deloras	female
Cecil	male
Pearline	female
Mickey	male
Jeramy	male
Svetlana	female
Bryce	male
Boyd	male
Kaila	female
Angelika	female
Evelyn	female
Cristina	female
Willard	male
Dell	female
Darius	male
Sanjuanita	female
Shanita	female
Melissa	female
Britta	female
Cleta	female
Lajuana	female
Miss	female
Evangeline	female
Elfriede	female
Karry	female
Dulcie	female
Cornelius	male
Elfrieda	female
Lavon	female
Devorah	female
Bella	female
Elden	male
Irving	male
Allyn	female
Cheree	female
Nita	female
Brenton	male
Terrance	male
Shakira	female
Crystal	female
Kyung	female
Sophie	female
Kenna	female
Rosalyn	female
Sophia	female
Eloisa	female
Santiago	male
Felicia	female
Eloise	female
Jeanine	female
Beatrice	female
Lorelei	female
Jade	female
Georgeanna	female
Jada	female
Deonna	female
Lakeesha	female
Emely	female
Dorris	female
Rocio	female
Ehtel	female
Kori	female
Leslee	female
Rosalee	female
Edyth	female
Maren	female
Jenny	female
Na	female
Isidro	male
Wyatt	male
Romeo	male
Lyle	male
Cathi	female
Yoshiko	female
Lyla	female
Jenni	female
Alanna	female
Johna	female
Annamae	female
Dalila	female
Meghann	female
Jenna	female
Gabrielle	female
Jesse	male
Thurman	male
Apryl	female
Eli	male
Tamala	female
Verlie	female
Heidy	female
Dorie	female
Faviola	female
Eleanora	female
Jewel	female
Eleanore	female
Dorothy	female
Luther	male
Erlene	female
Alphonso	male
Cherri	female
Heide	female
Alphonse	male
Tawanna	female
Doris	female
Tamela	female
Minerva	female
Roni	female
Lee	male
Ethan	male
Dedra	female
Rona	female
Sherly	female
Len	male
Leo	male
Kallie	female
Sanora	female
Tarsha	female
Booker	male
Franklin	male
Isidra	female
Mireya	female
Jetta	female
Shantay	female
Cynthia	female
Natalie	female
Kerstin	female
Laurice	female
Natalia	female
Bernie	male
Orval	male
Eugenio	male
Shakita	female
Billie	female
Genna	female
Yuette	female
Hubert	male
Tanna	female
Verline	female
Valentine	male
Vertie	female
Denice	female
Florinda	female
Wai	female
Keri	female
Bret	male
Nanette	female
Kristal	female
Risa	female
Kristan	female
Josette	female
Nidia	female
Collen	female
Audrea	female
Jona	female
Eleonor	female
Jong	female
Aura	female
Alfred	male
Joni	female
Cherly	female
Shelli	female
Ethyl	female
Wynona	female
Dianna	female
Waldo	male
Beckie	female
Nikia	female
Rafaela	female
Tommie	male
Tobias	male
Ricky	male
Margarett	female
Elvia	female
Tamica	female
Starr	female
Liz	female
Evonne	female
Jeanmarie	female
Williams	male
Deedee	female
Lenna	female
Audrey	female
Madison	female
Tiffany	female
Kazuko	female
Tashia	female
Easter	female
Kaye	female
Glendora	female
Letitia	female
Nilsa	female
Marcelle	female
Marcella	female
Harvey	male
Jacob	male
Alpha	female
Kylee	female
Rebecca	female
Iesha	female
Anissa	female
Dale	male
Bennett	male
Viviana	female
Siu	female
Bobette	female
Jocelyn	female
Lashawna	female
Sage	female
Lamont	male
Florida	female
Salena	female
Yuk	female
Brittanie	female
Stephan	male
Yun	female
Raylene	female
Genevie	female
Elda	female
Marcene	female
Ulrike	female
Bridgett	female
Randi	female
Adah	female
Reta	female
Jessica	female
Elodia	female
Geoffrey	male
Roscoe	male
Carmelia	female
Hilde	female
Miguelina	female
Julissa	female
Hilda	female
Tad	male
Luanne	female
Arletha	female
Wilfred	male
Luanna	female
Noella	female
Tam	female
Belva	female
Ginny	female
Tai	female
Delila	female
Rutha	female
Rowena	female
Glynda	female
Zulema	female
Jin	female
Libbie	female
Dodie	female
Jim	male
Benny	male
Tawna	female
Federico	male
Catalina	female
Angella	female
Roger	male
Miki	female
Pandora	female
Pamella	female
Malisa	female
Ellyn	female
Gil	male
Debbra	female
Lizbeth	female
Kirk	male
Shani	female
Zella	female
Elvina	female
Shane	male
Sofia	female
Shana	female
Frederic	male
Zenia	female
Mertie	female
Rico	male
Sherley	female
Cassaundra	female
Lisbeth	female
Treva	female
Nickole	female
Hershel	male
Marylou	female
Myriam	female
Roselia	female
Cleo	female
Krysta	female
Veola	female
Destiny	female
Indira	female
Theola	female
Teena	female
Charlott	female
Isabella	female
Melodee	female
Ariana	female
Lucy	female
Gus	male
Simone	female
Alayna	female
Marcelo	male
Blaine	male
Simonne	female
Tameka	female
Meaghan	female
Jesusita	female
Suzette	female
Ruthie	female
Gilda	female
Alix	female
Delilah	female
Beau	male
Maryjo	female
Shay	female
Carroll	male
Hui	female
Tana	female
Oretha	female
Meridith	female
Latina	female
Shad	male
Shae	female
Lisette	female
Elia	female
Penni	female
Shan	female
Aron	male
Warner	male
Annis	female
Annabell	female
Collette	female
Melinda	female
Loan	female
Stefan	male
Reba	female
Tracie	female
Charlsie	female
Adria	female
Norah	female
Derrick	male
David	male
Rima	female
Annie	female
Henry	male
Lynsey	female
Kesha	female
Dalia	female
Douglas	male
Ashli	female
Celina	female
Sharolyn	female
Leeanne	female
Latoyia	female
Felisa	female
Temika	female
Dallas	male
Quinn	male
Aaron	male
Luci	female
Ashly	female
Lorilee	female
Tamiko	female
Harlan	male
Tessa	female
Deon	male
Lewis	male
Missy	female
Sylvia	female
Carlita	female
Sylvie	female
Marty	male
Mui	female
Leonia	female
Rey	male
Mozelle	female
Leonie	female
Teddy	male
Marnie	female
Queenie	female
Kurtis	male
Meagan	female
Loura	female
Augusta	female
Marti	female
Marth	female
Yvone	female
Jacqui	female
Tambra	female
Marta	female
Gertude	female
Rea	female
Gaylene	female
Ellamae	female
Jacque	female
Lance	male
Evangelina	female
Doreen	female
Desirae	female
Sabina	female
Lacie	female
Pamelia	female
Kyla	female
Melda	female
Lynetta	female
Eleni	female
Tamra	female
Rodrick	male
Peg	female
Clay	male
Charlesetta	female
Lexie	female
Johnie	male
Brigitte	female
Sabra	female
Boris	male
Enedina	female
Ileen	female
Arminda	female
Theressa	female
Vannesa	female
Glennie	female
Waneta	female
Kimberlie	female
Odilia	female
Corey	male
Rodrigo	male
Glennis	female
Argentina	female
Thomasine	female
Rickey	male
Aleisha	female
Jaquelyn	female
Loise	female
Shenika	female
Krystin	female
Chantal	female
Jordon	male
Charita	female
Tamisha	female
Takisha	female
Natalya	female
Kelsi	female
Jude	male
Kattie	female
Chantay	female
Judy	female
So	female
Elene	female
Noel	male
Mitsuko	female
Vicky	female
Mozella	female
Charity	female
Joshua	male
Jermaine	male
Lelia	female
Brett	male
Hunter	male
Shavonne	female
Orville	male
Jackeline	female
Angelyn	female
Nohemi	female
Moises	male
Loretta	female
Shaina	female
Lanora	female
Sixta	female
Katherina	female
Jeffrey	male
Tammie	female
Wenona	female
Aliza	female
Penney	female
Oneida	female
Pearlie	female
Dillon	male
Eliz	female
Stuart	male
Particia	female
Brigid	female
Silva	female
Yasmine	female
Deshawn	male
Melina	female
Shonta	female
Dayna	female
Angila	female
Tonya	female
Pearl	female
Sima	female
Kaylee	female
Yvette	female
Mirna	female
Delorse	female
Oswaldo	male
Monika	female
Jolie	female
Efrain	male
Lavona	female
Denyse	female
Janna	female
Davis	male
Clark	male
Glenn	male
Clare	female
Jamaal	male
Fallon	female
Dewitt	male
Camellia	female
Philomena	female
Jaqueline	female
Maura	female
Heike	female
Denis	male
Claribel	female
Adrian	male
Dora	female
Eilene	female
Annice	female
Mayra	female
Ardith	female
Mauro	male
Christel	female
Agripina	female
Minna	female
Bettie	female
Nyla	female
Danilo	male
Hyun	female
Kali	female
Marita	female
Lorita	female
Zoraida	female
Tyisha	female
Augustus	male
Lino	male
Linn	female
Kaylene	female
Reed	male
Janeth	female
Linh	female
Ling	female
Berna	female
Curt	male
Son	male
Toney	male
Angelique	female
Loni	female
Oren	male
Pearly	female
Alethea	female
Lona	female
Michele	female
Cyrstal	female
Virgie	female
Long	male
Arthur	male
Brittney	female
Cheyenne	female
Sherice	female
Luz	female
Porter	male
Elinore	female
Maye	female
Paulita	female
Tamekia	female
Alishia	female
Andera	female
Digna	female
Rubye	female
Hyman	male
Susannah	female
Inocencia	female
Rosaura	female
Margaretta	female
Billy	male
Maryetta	female
Roxana	female
Shella	female
Shirly	female
Maya	female
Roxann	female
Beaulah	female
Arturo	male
Rosamaria	female
Glenna	female
Ursula	female
Samira	female
Chase	male
Keli	female
Nancee	female
Brittani	female
Barbera	female
Madlyn	female
Nancey	female
Phylis	female
Alida	female
Catarina	female
Justine	female
Shaquita	female
Nga	female
Cindi	female
Xuan	female
Marcelino	male
Frederick	male
Maudie	female
Dorian	male
Zenaida	female
Kanesha	female
Edmundo	male
Dania	female
Audie	female
Cindy	female
Bulah	female
Kanisha	female
Lon	male
Laveta	female
Bryant	male
Ludie	female
Birdie	female
Ericka	female
Oscar	male
Buena	female
Stephine	female
Alleen	female
Leena	female
Myong	female
Adam	male
Adan	male
Isabell	female
Wilmer	male
Keneth	male
Dena	female
Waylon	male
Kortney	female
Benjamin	male
Kendall	male
Manie	female
Shu	female
Ed	male
Geraldine	female
Wava	female
Karrie	female
Cordell	male
Liana	female
Sha	female
Keeley	female
Annalisa	female
Liane	female
Larisa	female
Marisha	female
Nubia	female
Lourdes	female
Margherita	female
Sommer	female
Contessa	female
Jacqualine	female
Kerry	male
Antonette	female
Katherin	female
Debrah	female
Leanora	female
Charise	female
Amie	female
Wiley	male
Gretchen	female
Hildegard	female
Latoya	female
Andria	female
Hang	female
Lizeth	female
Rusty	male
Maragaret	female
Evelia	female
Helen	female
Evelin	female
Londa	female
Tisha	female
Elton	male
Jonelle	female
Lakesha	female
Elroy	male
Bethann	female
Galina	female
Marybeth	female
Cornelia	female
Nina	female
Voncile	female
Carletta	female
Mckinley	male
Georgia	female
Harland	male
Ira	male
Daphne	female
Adalberto	male
Mindi	female
Jeneva	female
Amado	male
Martina	female
Don	male
Jestine	female
Frankie	male
Yukiko	female
Malcom	male
Macy	female
Lynna	female
Ardell	female
Loree	female
Mariette	female
Shemika	female
Tuyet	female
Candida	female
Isobel	female
Juliana	female
Chong	female
Florencia	female
Bryan	male
Lincoln	male
Nicky	male
Krissy	female
Hanna	female
Mikaela	female
Marshall	male
Frederica	female
Chelsie	female
Vickie	female
Nicki	female
Berry	male
Belia	female
Xavier	male
Tabitha	female
Phyliss	female
Morton	male
Enrique	male
Ken	male
Bryon	male
Tami	female
Adrienne	female
Earlean	female
Isa	female
Tama	female
Nova	female
Lynne	female
Sheila	female
Merrilee	female
Hattie	female
Ismael	male
Yahaira	female
Judith	female
Mistie	female
Shalonda	female
Sterling	male
Humberto	male
Chadwick	male
Rocky	male
Daria	female
Dario	male
Barry	male
Nguyet	female
Suzi	female
Joanna	female
Jayna	female
Vinita	female
Thanh	male
Bethanie	female
Winnifred	female
Zina	female
Florine	female
Guy	male
Isaac	male
Crissy	female
Brandee	female
Launa	female
Alison	female
Sina	female
Kristel	female
Porfirio	male
Bernadine	female
Gussie	female
Kris	female
Janae	female
Margy	female
Norbert	male
Luana	female
Jolynn	female
Ninfa	female
Kyle	male
Brady	male
Keisha	female
Narcisa	female
Marge	female
Alyce	female
Chantell	female
Marisela	female
Anya	female
Grisel	female
Cesar	male
Kirsten	female
Margo	female
Gerry	male
Merilyn	female
Winfred	male
Taylor	male
Adina	female
Willena	female
Elza	female
Willene	female
Phebe	female
Gerri	female
Tyron	male
Florencio	male
Tonita	female
Vivien	female
Alana	female
Abraham	male
Kathie	female
Madalene	female
Alane	female
Delmar	male
Otilia	female
Tesha	female
Flossie	female
Bettyann	female
Elyse	female
Irmgard	female
Jorge	male
Goldie	female
Hayden	male
Demarcus	male
Yan	female
Sharri	female
Toshiko	female
Rolf	male
Katheleen	female
Madaline	female
Haydee	female
Maxima	female
Marilyn	female
Jenice	female
Tess	female
Eulalia	female
Willy	male
Clarine	female
Ernie	male
Sherrill	female
Malcolm	male
Pilar	female
Lesha	female
Ahmed	male
Jo	female
Ji	female
Margurite	female
Jerold	male
Yaeko	female
Isaiah	male
Nerissa	female
Ja	female
Monroe	male
Jc	male
Roselyn	female
Marilee	female
Robena	female
Evon	female
Ulysses	male
Claudette	female
Shelby	female
Tasha	female
Sherri	female
Rayna	female
Charles	male
Louella	female
Ramon	male
Spencer	male
Hassie	female
Juliette	female
Maryjane	female
Joaquina	female
Lizzie	female
Emmie	female
Sherry	female
Izola	female
Devora	female
Agustin	male
Shelba	female
Consuela	female
Anja	female
Ian	male
Keshia	female
Broderick	male
Harley	male
Malorie	female
Fran	female
Zachary	male
Albert	male
Larita	female
Abigail	female
Thalia	female
Denise	female
Adriane	female
Gillian	female
Deandrea	female
Cassidy	female
Darrick	male
Damaris	female
Tamar	female
Vernia	female
Catina	female
Pattie	female
Kerrie	female
Janell	female
Alycia	female
Tim	male
Kandis	female
Marin	female
Tomeka	female
Piedad	female
Mina	female
Mariel	female
Alden	male
Germaine	female
Adriene	female
Olivia	female
Tonette	female
Yen	female
Sharika	female
Syble	female
Jonathon	male
Cathrine	female
Fawn	female
Bethel	female
Yolande	female
Shayla	female
Zack	male
Leora	female
Susan	female
Annabel	female
Freeda	female
Antonio	male
Wanda	female
Patti	female
Pamala	female
Martine	female
Lura	female
Jake	male
Ryan	male
Lawanda	female
Annette	female
Theda	female
Vilma	female
Madge	female
Annetta	female
Bob	male
Nicole	female
Patty	female
Jacquelyn	female
Dagmar	female
Issac	male
Chante	female
Assunta	female
Jeane	female
Donette	female
Kiana	female
Keitha	female
Alyse	female
Donetta	female
Nellie	female
Modesto	male
Robbyn	female
Irena	female
Johanna	female
Korey	male
Irene	female
Randell	male
Johanne	female
Maggie	female
Charline	female
Trish	female
Zoe	female
Tonda	female
Rosena	female
Kami	female
Anamaria	female
Scotty	male
Agueda	female
Mason	male
Reda	female
Wayne	male
Manda	female
Shellie	female
Joselyn	female
Neely	female
Mandi	female
Monty	male
Lea	female
Clemencia	female
Darwin	male
Myrtie	female
Ana	female
Ann	female
Cinderella	female
Chasidy	female
Leilani	female
Marilynn	female
Myrtis	female
Pamela	female
Sol	male
Zora	female
Deanne	female
Wilhelmina	female
Brice	male
Eun	female
Celinda	female
Edwina	female
Mohamed	male
Mario	male
Summer	female
Flora	female
Thuy	female
Leonida	female
Marcelene	female
Nada	female
Lakendra	female
Adolph	male
Jerry	male
Murray	male
Juanita	female
Olimpia	female
Isela	female
Connie	female
Graciela	female
Sheilah	female
Lauralee	female
Vicente	male
Vicenta	female
Marcos	male
Charisse	female
Kiersten	female
Mandie	female
Charissa	female
Altha	female
Trudie	female
Kathryn	female
Nadene	female
Arnette	female
Almeta	female
Darin	male
Omer	male
Tatum	female
Cheryll	female
Tameika	female
Santana	female
Sandee	female
Lucio	male
Blossom	female
Cassondra	female
Erna	female
Terrence	male
Guadalupe	female
Jill	female
Essie	female
Jesusa	female
Dalton	male
Reyes	male
Claretha	female
Aileen	female
Marcie	female
Yasuko	female
Gregorio	male
Tisa	female
Cristi	female
Stanton	male
Winter	female
Branden	male
Tish	female
Phung	female
Bethany	female
Tran	female
Manual	male
Byron	male
Gregoria	female
Juliane	female
Catherina	female
Chuck	male
Harris	male
Cletus	male
Daisey	female
Crystle	female
Tena	female
Elenore	female
Kathlyn	female
Lucie	female
Hye	female
Kecia	female
Mi	female
Ramiro	male
Penny	female
Hyo	female
Britteny	female
Colby	male
Luis	male
Breanne	female
Isadora	female
Ying	female
Breanna	female
Tiesha	female
Keturah	female
Serita	female
Arlen	male
Marva	female
Leesa	female
Marlon	male
Odell	male
Ashlie	female
Katelyn	female
Tera	female
Stacy	female
Leda	female
Rebbecca	female
Adolfo	male
Vivan	female
Olin	male
Sheron	female
Thomasena	female
Jonas	male
Gilberto	male
Staci	female
Yon	female
Reginia	female
Merna	female
Marquis	male
Leroy	male
Bettye	female
Laquita	female
Thersa	female
Levi	male
Velva	female
Dierdre	female
Nadine	female
Dawne	female
Mikel	male
Bianca	female
Dawna	female
Tammara	female
Signe	female
Candyce	female
Jazmine	female
Vasiliki	female
Faustino	male
Brynn	female
Faustina	female
Barbie	female
Ping	female
Emerita	female
Osvaldo	male
Sparkle	female
Logan	male
Siobhan	female
Violet	female
Raye	female
Lelah	female
Sharleen	female
Loren	male
Azucena	female
Rashad	male
Aleta	female
Marhta	female
Lieselotte	female
Raisa	female
Ocie	female
Floyd	male
Renita	female
Louanne	female
Mathew	male
Porsha	female
Lindsey	female
Lashaunda	female
Virgen	female
Delmy	female
Dara	female
Inell	female
Kamala	female
Taisha	female
Lacey	female
Birgit	female
Pia	female
Leontine	female
Telma	female
Lucius	male
Ivana	female
Arlene	female
Lyndsay	female
Foster	male
Arlena	female
Yuko	female
Janay	female
Georgeann	female
Yuki	female
Raleigh	male
Sarai	female
Fidelia	female
Tomiko	female
Saran	female
Joesph	male
Cierra	female
Benito	male
Magan	female
Lavonia	female
Ranee	female
Moriah	female
Krysten	female
Samantha	female
Virgina	female
Tabetha	female
Beatris	female
Garth	male
Amelia	female
Philip	male
Madelaine	female
Beatriz	female
Junior	male
Tula	female
Yoshie	female
Brendon	male
Ok	female
Glayds	female
Helena	female
Reginald	male
Caleb	male
Antonina	female
Fleta	female
Kimberly	female
Zoila	female
Maia	female
Angelo	male
Eduardo	male
Lilly	female
Rheba	female
Billye	female
Lashonda	female
Helene	female
Shavon	female
Idella	female
Cordia	female
Ria	female
Norene	female
Cordie	female
Lazaro	male
Katheryn	female
Chance	male
Pedro	male
Del	male
Kory	male
Cristen	female
Yael	female
Deb	female
Janey	female
Tawny	female
Fanny	female
Ivelisse	female
Cristopher	male
Ami	female
Clarice	female
Myrtle	female
Lila	female
Landon	male
Callie	female
Nella	female
Todd	male
Lili	female
Nelle	female
Ashanti	female
Amy	female
Despina	female
Scot	male
Carita	female
Ernesto	male
Joella	female
Phillip	male
Bailey	female
Rebeca	female
Sacha	female
Lily	female
Shawanda	female
Kathyrn	female
Dewey	male
Brock	male
Jacqueline	female
Jeromy	male
Margareta	female
Lucas	male
Luann	female
Mirella	female
Errol	male
Steven	male
Emilio	male
Shanice	female
Erminia	female
Antoine	male
Corina	female
Lucien	male
Yer	female
Vito	male
Gordon	male
Edie	female
Vita	female
Gracia	female
Lakeisha	female
Jerome	male
Karey	female
Gertrude	female
Enriqueta	female
Kena	female
Elba	female
Carina	female
Collene	female
Hobert	male
Sherise	female
Tasia	female
Wendi	female
Francine	female
Ermelinda	female
Shanna	female
Kent	male
Rosio	female
Anastasia	female
Evelina	female
Michale	male
Willis	male
Hope	female
Eveline	female
Portia	female
Stefania	female
Melisa	female
Helga	female
Darnell	male
Theodore	male
Latia	female
Ned	male
Palmer	male
Paola	female
Lorraine	female
Mable	female
Karissa	female
Joannie	female
Kum	female
Vanna	female
Milo	male
Holly	female
Rigoberto	male
Rina	female
Ardelle	female
Leoma	female
Genaro	male
Jalisa	female
Karena	female
Claudie	female
Nelda	female
Garland	male
Phil	male
Sunny	female
Creola	female
Claudio	male
Floretta	female
Darron	male
Iluminada	female
Tilda	female
Kaitlin	female
Joyce	female
Zandra	female
Filomena	female
Tyson	male
Vern	male
Mitchell	male
Joanie	female
Dulce	female
Carlena	female
Marybelle	female
Carlene	female
Nancie	female
Bennie	male
Blondell	female
Tari	female
Shawnda	female
Derick	male
Allison	female
Xenia	female
Delphine	female
Lakenya	female
Ty	male
Dakota	female
Kayleigh	female
Ara	female
Joan	female
Princess	female
Sierra	female
Kisha	female
Mee	female
Pearlene	female
Brittaney	female
Lilliana	female
Arlyne	female
Christin	female
Lavette	female
Christia	female
Tomasa	female
Mei	female
Christie	female
Krista	female
Merrill	male
Glynis	female
Gerald	male
Amos	male
Jammie	female
Lynell	female
Lonny	male
Elidia	female
Tara	female
Herta	female
Angla	female
Venetta	female
Dottie	female
Angle	female
Abdul	male
Nicholle	female
Sadye	female
Beula	female
Marica	female
Seema	female
Melonie	female
Iva	female
Elisha	female
Nathanael	male
Sherlene	female
Josef	male
Rich	male
Rosalba	female
Dexter	male
Jutta	female
Salvador	male
Gaynell	female
Johnetta	female
Tommy	male
Tynisha	female
Jama	female
Johnette	female
Minnie	female
Aiko	female
Yulanda	female
Damion	male
Bernetta	female
Francesco	male
Latrisha	female
Willian	male
Lurlene	female
Brent	male
Ta	female
Coleen	female
Jolene	female
Sandie	female
Reuben	male
Yelena	female
Chieko	female
Ai	female
Reagan	female
Rex	male
Lezlie	female
Al	male
Fatimah	female
Drusilla	female
Maybelle	female
Octavia	female
Louisa	female
Kathey	female
Katrina	female
Georgianne	female
Chrystal	female
Kaycee	female
Arnold	male
Octavio	male
Gabriele	female
Lucienne	female
Autumn	female
Katharyn	female
Ron	male
Alton	male
Benedict	male
Elvis	male
Myron	male
Rochell	female
Honey	female
Gretta	female
Vanessa	female
Joseph	male
Renetta	female
Lael	female
Elvin	male
Arla	female
Elvie	female
Janene	female
Candance	female
Isaias	male
Mike	male
Alysia	female
Christeen	female
Buddy	male
Mika	female
Ressie	female
Randa	female
Chet	male
Shaquana	female
Cyrus	male
Travis	male
Randy	male
Filiberto	male
Luciana	female
Giuseppina	female
Luciano	male
Cher	female
Moses	male
Alisia	female
Kaley	female
Pricilla	female
Iola	female
Loreen	female
Roselee	female
Mona	female
Salvatore	male
Many	female
Nila	female
Vida	female
Maris	female
Mardell	female
Kandra	female
Aldo	male
Mana	female
Julianne	female
Nakita	female
Corrin	female
Cortez	male
Analisa	female
Madonna	female
Libby	female
Kandice	female
Malvina	female
Cherlyn	female
Maria	female
Deloise	female
Rosemarie	female
Sharmaine	female
Maybell	female
Linnie	female
Dusty	male
Orlando	male
Cassy	female
Micheline	female
Drew	male
Michelina	female
Ashlee	female
Star	female
Evan	male
Kera	female
Loralee	female
Dusti	female
Jasmine	female
Cassi	female
Dori	female
Jaymie	female
Linsey	female
Lionel	male
Irish	female
Rosanna	female
Raymon	male
Lai	female
Clemmie	female
Kathleen	female
Latesha	female
Gemma	female
Robt	male
Rodney	male
Marchelle	female
Justina	female
Carson	male
Otis	male
Grover	male
Carlos	male
Caron	female
Lydia	female
Carol	female
Regena	female
Stormy	female
Rasheeda	female
Ilse	female
Magdalene	female
Danita	female
Suzy	female
Malka	female
Guillermina	female
Codi	female
Erline	female
Kirstie	female
Vanesa	female
Lashell	female
Dannielle	female
Kirstin	female
Stephaine	female
Joie	female
Lissette	female
Cody	male
Cinthia	female
Tammi	female
Leeanna	female
Winifred	female
Carylon	female
Shalon	female
Denver	male
Pam	female
Altagracia	female
Tammy	female
Milagros	female
Jolanda	female
Ashton	female
Jeffery	male
Shanon	female
Karima	female
Golden	female
Velia	female
Nickolas	male
Erick	male
Erich	male
Charley	male
Jospeh	male
Elsa	female
Ola	female
Juana	female
Else	female
Elsy	female
Leslie	female
Roslyn	female
Joaquin	male
Tandra	female
Alita	female
Lavonda	female
Brianna	female
Johnathon	male
Susy	female
Kermit	male
Raelene	female
Walton	male
Julius	male
Kathe	female
Catherine	female
Ruthanne	female
Page	female
Steve	male
Sherron	female
Gidget	female
Ileana	female
Loriann	female
Hilaria	female
Aretha	female
Millie	female
Lavina	female
Rhett	male
Ashely	female
Marvel	female
Wynell	female
Jerrold	male
Chanell	female
Mechelle	female
Shayne	male
Trudy	female
Xiao	female
Shayna	female
Miesha	female
Karly	female
Jaime	male
Jenifer	female
Fe	female
Sheena	female
Natisha	female
Gearldine	female
Neda	female
Qiana	female
Lamar	male
Oliver	male
Lovie	female
Cecilia	female
Addie	female
Jerlene	female
Norberto	male
Mellisa	female
Ayana	female
Randee	female
Ferdinand	male
Claudia	female
Windy	female
Karla	female
Clinton	male
Shirlene	female
Corrie	female
Eugena	female
Bong	female
Lindsy	female
Lowell	male
Alexandria	female
Clarence	male
Zita	female
Debby	female
Franklyn	male
Vicki	female
Rubi	female
Shirl	female
Sammie	male
Greta	female
Danika	female
Eura	female
Genesis	female
Chanda	female
Diego	male
Jimmy	male
Jed	male
Debbi	female
Kenny	male
Maribeth	female
Melvin	male
Jen	female
Ivory	male
Nydia	female
Gudrun	female
Kathy	female
Marg	female
Taunya	female
Mara	female
Marc	male
Jamison	male
Demetria	female
Jason	male
Sharell	female
Mark	male
Kathi	female
Talitha	female
Ammie	female
Latricia	female
Enoch	male
Donnette	female
Vennie	female
Marx	female
Verena	female
Yi	female
Hyacinth	female
Gaston	male
Euna	female
Lucinda	female
Kimi	female
Molly	female
Lourie	female
Tom	male
Floria	female
Anneliese	female
Toi	female
Wade	male
Shira	female
Yu	female
Berneice	female
Caitlyn	female
Hipolito	male
Milford	male
Jacalyn	female
Velvet	female
Treena	female
Graham	male
Hugo	male
Hugh	male
Trena	female
Ciera	female
Rafael	male
Alda	female
Tod	male
Lavenia	female
Trent	male
Carlota	female
Marvella	female
Deangelo	male
Arianne	female
Shena	female
Lenard	male
Lizzette	female
Rae	female
Abe	male
Melany	female
Hertha	female
Deidra	female
Lupita	female
Barbar	female
Maisie	female
Lettie	female
Vania	female
Eleanor	female
Dot	female
Jennie	female
Elna	female
Consuelo	female
Melani	female
Sarina	female
Shantell	female
Leona	female
Danna	female
Natividad	female
Leone	female
Bonita	female
Bradford	male
Wes	male
Hildegarde	female
Jina	female
Jacklyn	female
Efren	male
Caroyln	female
Antonietta	female
Tomi	female
Donnetta	female
Miguel	male
Fredricka	female
Otto	male
Robby	male
Kayce	female
Hilario	male
Thi	female
Cherise	female
Adriana	female
Ricarda	female
Jenelle	female
Marlana	female
Bridget	female
Vivian	female
Estella	female
Retha	female
Etta	female
Angelena	female
Marquitta	female
Sid	male
Celestina	female
Junko	female
Dannette	female
Dorla	female
Yoko	female
Coreen	female
Doug	male
Deandre	male
Cyril	male
Effie	female
Leonel	male
Deandra	female
Maximina	female
Rosalva	female
Bebe	female
Marlena	female
Sudie	female
Zula	female
Marlene	female
Josephine	female
Selena	female
Carly	female
Candra	female
Josephina	female
Dorthey	female
Marlin	male
Bradley	male
Stella	female
Carla	female
Fabian	male
Kimberely	female
Dorthea	female
Elissa	female
Carli	female
Ozella	female
Carlo	male
Deetta	female
Twana	female
Armand	male
Deane	female
Alecia	female
Roberta	female
Hannelore	female
Deana	female
Jeremiah	male
Esperanza	female
Moira	female
Kristian	female
Darell	male
Rickie	male
Davida	female
Trang	female
Joana	female
Julieann	female
Mikki	female
Kristina	female
Malika	female
Ardelia	female
Vaughn	male
Lady	female
Katelin	female
Shirlee	female
Leta	female
Inger	female
Shoshana	female
Ivy	female
Mariana	female
Diann	female
Diana	female
Mariann	female
Diane	female
Rosa	female
Laura	female
Miles	male
Herbert	male
Rosy	female
Shemeka	female
Tonja	female
Jefferson	male
Conrad	male
Tamesha	female
Hiedi	female
Nettie	female
Sena	female
Domingo	male
Bobbye	female
Boyce	male
Devin	male
Heather	female
Aisha	female
Dominga	female
Albertha	female
Damian	male
Victorina	female
Laurena	female
Danny	male
Elias	male
Cedrick	male
Machelle	female
Stan	male
Tammera	female
Georgie	female
Joslyn	female
Adela	female
Floy	female
Lakiesha	female
Darlena	female
Flor	female
Darlene	female
Johnnie	male
Mendy	female
Roseline	female
Ludivina	female
Jame	male
Stephane	female
Whitney	female
Granville	male
Stephani	female
Russ	male
Ida	female
Oliva	female
Jami	female
Priscilla	female
Lorrine	female
Allyson	female
Ambrose	male
Tennille	female
Danille	female
Carter	male
Fidela	female
Crista	female
Garrett	male
Rachel	female
Temeka	female
Anisa	female
Erwin	male
Luna	female
Emelia	female
Shelton	male
Leann	female
Raul	male
Gilbert	male
Deidre	female
Marie	female
Florentino	male
Torie	female
Glen	male
Stacee	female
Pamula	female
Corinne	female
Terica	female
Lillie	female
Kathrine	female
Junie	female
Lillia	female
Moon	female
Salley	female
Olevia	female
Reanna	female
Bernita	female
Linwood	male
Julietta	female
Akilah	female
Fermin	male
Stacey	female
Jacinta	female
Lashunda	female
Petra	female
Erlinda	female
Chad	male
Chae	female
Bertram	male
Spring	female
Chan	female
Zonia	female
Chas	male
Margret	female
Jarrod	male
Izetta	female
Tyree	male
Chau	female
Carmine	male
Shawnee	female
Jonna	female
Solange	female
Chanel	female
Illa	female
Stewart	male
Jacinto	male
Lory	female
Gerardo	male
Tyrone	male
Kathryne	female
Dede	female
Nikita	female
Rossie	female
Theresa	female
Shavonda	female
Adella	female
Asa	male
Jessi	female
Lori	female
Darrell	male
Oleta	female
Lore	female
Kizzie	female
Margorie	female
Katia	female
Enola	female
Sylvester	male
Shanika	female
Numbers	male
Karon	female
Barabara	female
Brandi	female
Layne	female
Leland	male
Joette	female
Herb	male
Branda	female
Elease	female
Brande	female
Una	female
Brandy	female
Maryalice	female
Oda	female
Onita	female
Rogelio	male
Karlene	female
Gabriella	female
Bernardo	male
Milton	male
Viva	female
Angeles	female
Oma	female
Emmanuel	male
Alexa	female
Bonny	female
Stevie	male
Robbi	female
Sharie	female
Woodrow	male
Nu	female
Dann	female
Kristle	female
Melaine	female
Allene	female
Dani	female
Dane	male
Alfreda	female
Clint	male
Dana	female
Shawnta	female
Shiloh	female
Minh	male
Columbus	male
Hermine	female
Betsey	female
Dannie	male
Melodi	female
Olive	female
Tandy	female
Vernon	male
Stefanie	female
Trisha	female
Raina	female
Nicola	female
Virgilio	male
Marcellus	male
Karleen	female
Barbra	female
Fidel	male
Zane	male
Felice	female
Giselle	female
Hazel	female
Zana	female
Judie	female
Graig	male
Noelia	female
Annelle	female
Estefana	female
Hester	female
Eulah	female
Halina	female
Sana	female
Lesli	female
Nickie	female
Simon	male
Roselle	female
Marielle	female
Doria	female
Cammy	female
Gisele	female
Valentin	male
Allie	female
Laurene	female
Kristi	female
Ettie	female
Karren	female
Karma	female
Dagny	female
Marinda	female
Salina	female
Ward	male
Lorinda	female
Deedra	female
Laurinda	female
Cristal	female
Brinda	female
Gene	male
Jillian	female
Lilian	female
Hyon	female
Reva	female
Mackenzie	female
Grady	male
Madeline	female
Markus	male
Arleen	female
Pearle	female
Carolina	female
Lenita	female
Irvin	male
Renaldo	male
Heidi	female
Maynard	male
Ethelyn	female
Laci	female
Benita	female
Alfredia	female
Roosevelt	male
Patricia	female
Emerson	male
Johnson	male
Leigha	female
Kimberli	female
Racquel	female
Bess	female
Rupert	male
Tobi	female
Leticia	female
Geralyn	female
Angelica	female
Tamara	female
Wilford	male
Noah	male
Mallory	female
Kenyetta	female
Ka	female
Silas	male
Lawrence	male
Karolyn	female
Elisabeth	female
Myrl	female
Andre	male
Tien	female
Sharonda	female
Leandra	female
Andra	female
Rory	male
Gail	female
Leandro	male
Ligia	female
Keith	male
Tennie	female
Kerri	female
Bryanna	female
Lindy	female
Agustina	female
Celestine	female
Myrta	female
Brunilda	female
Debi	female
Song	female
Zena	female
Lissa	female
Thu	female
Reiko	female
Rueben	male
Jeffry	male
Terresa	female
Luisa	female
Hilma	female
Belen	female
Mila	female
Luise	female
Burton	male
Linda	female
Ricardo	male
Candelaria	female
Lorretta	female
Coy	male
Exie	female
Eryn	female
Letisha	female
Ahmad	male
Joya	female
Eldridge	male
Tanja	female
Stephania	female
Nia	female
Kitty	female
Margarette	female
Kit	female
Dolly	female
Alex	(male
Nora	female
Eldon	male
Jaleesa	female
Kim	(female
Orpha	female
Hilton	male
Kia	female
Leonardo	male
Livia	female
Margert	female
Nicolas	male
Jaimee	female
Daren	male
Yolonda	female
Everette	male
Abbey	female
Emanuel	male
Roderick	male
Solomon	male
Armando	male
Daisy	female
Melynda	female
Courtney	female
Talia	female
Tomas	male
Kenda	female
Myles	male
Tuan	male
Janet	female
Nona	female
Reatha	female
Lue	female
Joetta	female
Lucrecia	female
Stephanie	female
Les	male
Janee	female
Mica	female
Letty	female
Janessa	female
Cecille	female
Tomika	female
Terrell	male
Janel	female
Delmer	male
Domitila	female
Marquita	female
Charolette	female
Steffanie	female
Genoveva	female
Denny	male
Donnie	male
Donny	male
Chassidy	female
Laverne	female
Christen	female
Maricruz	female
Laverna	female
Donna	female
Noelle	female
Alvaro	male
Devon	male
Clifford	male
Huong	female
Lonnie	male
Linnea	female
Avery	male
Charlyn	female
Lanette	female
Alta	female
Marya	female
Laurence	male
Carmelina	female
Edward	male
Gracie	female
Rana	female
Maile	female
Zachery	male
Tracy	female
Leia	female
Leif	male
Carma	female
Tamera	female
Alexia	female
Theo	male
Myesha	female
Vera	female
Ramona	female
Vanita	female
Otha	male
Elwanda	female
Thea	female
Debra	female
Melvina	female
Shameka	female
Annemarie	female
Roxane	female
Riley	male
Cedric	male
Ernest	male
Lyda	female
Mabelle	female
Eunice	female
Dorotha	female
Ferne	female
Deadra	female
Danyelle	female
Cherry	female
Everett	male
Jeff	male
Lesley	female
Shauna	female
Lahoma	female
Arline	female
Rozanne	female
Fatima	female
Nolan	male
Andy	male
Claudine	female
Ike	male
Sulema	female
Shanae	female
Detra	female
Tiffani	female
Juliet	female
Ebony	female
Teresita	female
Eileen	female
Katlyn	female
Ezra	male
Alicia	female
Claire	female
Wallace	male
Elicia	female
German	male
Delsie	female
Fred	male
Elmira	female
Su	female
Fae	female
Danyell	female
Elliott	male
Johana	female
Aletha	female
Doreatha	female
Dinorah	female
Jackqueline	female
Shanell	female
Bill	male
Johnathan	male
Talisha	female
Sonny	male
Clora	female
Arlean	female
Coletta	female
Kasha	female
Rhea	female
Randall	male
Mora	female
Rosemary	female
Shakia	female
Gloria	female
Yung	female
Lang	female
Sabine	female
Kristyn	female
Shandra	female
Celsa	female
Dewayne	male
Ghislaine	female
Anh	female
Elin	female
Jettie	female
Elfreda	female
Teressa	female
Veronique	female
Marina	female
Cherilyn	female
Daniell	female
Bruno	male
Dorsey	male
Cherish	female
Daniela	female
Coleman	male
Bruna	female
Bunny	female
Malena	female
Margeret	female
Kari	female
Kaci	female
Doloris	female
Gay	female
Norris	male
Lucina	female
Minda	female
Magen	female
Shea	female
India	female
Karisa	female
Soo	female
Shantae	female
Michell	female
Buck	male
Yang	female
Kacy	female
Karl	male
Kristopher	male
Lynwood	male
Lilia	female
Jacqulyn	female
Deann	female
Klara	female
Kayleen	female
Caridad	female
Sunni	female
Gabriel	male
Lorean	female
Kirby	male
Mohammad	male
Marylyn	female
Neta	female
Lorie	female
Loma	female
Benton	male
Loria	female
Jannette	female
Aracelis	female
Jared	male
Melita	female
Lenora	female
Lashawnda	female
Truman	male
Mozell	female
Lenore	female
Senaida	female
Terrie	female
Eladia	female
Conception	female
Art	male
Rachele	female
Kristine	female
Elanor	female
Pamila	female
Sharla	female
Rachell	female
Timmy	male
Daphine	female
Edelmira	female
Maximo	male
Viki	female
Fumiko	female
Chasity	female
Delta	female
Socorro	female
Pennie	female
Gino	male
Wendy	female
Kevin	male
Barrett	male
Jenell	female
Shila	female
Eula	female
Jamar	male
Sindy	female
Anibal	male
Sook	female
Edith	female
Cindie	female
Bo	male
Beryl	female
Soon	female
Masako	female
Shelly	female
Romelia	female
Dirk	male
Willetta	female
Angelina	female
Jaunita	female
Kiera	female
Willette	female
Willa	female
Nenita	female
Jamal	male
Antione	male
Veronika	female
Tia	female
Adelaide	female
Tania	female
Astrid	female
Loida	female
Timika	female
Gregg	male
September	female
Hsiu	female
Raeann	female
Angeline	female
Alisha	female
Deanna	female
Shela	female
Prince	male
Damien	male
Morris	male
Avis	female
Ingrid	female
Ervin	male
Giuseppe	male
Huey	male
Emmy	female
Maryln	female
Kristeen	female
Odis	male
Treasa	female
Jerrie	female
Jone	female
Elois	female
Edna	female
Kelsey	female
Pura	female
Zelda	female
Arron	male
Ronald	male
Alline	female
Sharilyn	female
Suanne	female
Felipe	male
Lavera	female
Peggie	female
Maragret	female
Peter	male
Evelynn	female
Cythia	female
Sarita	female
Janella	female
Stanford	male
Soledad	female
Janelle	female
Salome	female
Trey	male
Mariano	male
Allena	female
Lawanna	female
Rose	female
Manuel	male
Felica	female
Saul	male
Rudolf	male
Amada	female
Shannon	female
Sheba	female
Hedwig	female
Antwan	male
Mathilda	female
Felicita	female
Synthia	female
Estelle	female
Larhonda	female
Francene	female
Berniece	female
Sergio	male
Terisa	female
Hildred	female
Cecila	female
Arvilla	female
Bula	female
Cassie	female
Alesia	female
Julianna	female
King	male
Marlo	female
Rebekah	female
Ashley	female
Christine	female
Kina	female
Annamarie	female
Rob	male
Lenny	male
Rod	male
Allan	male
Epifania	female
Jerri	female
Roy	male
Antionette	female
Bobbie	female
Romaine	female
Roland	male
Charmain	female
Ashlea	female
Taren	female
Luetta	female
Nicholas	male
Marlys	female
Cristy	female
Elizabet	female
Leopoldo	male
Trudi	female
Kenia	female
Elmo	male
Ellena	female
Michael	male
Lovetta	female
Jonah	male
Ladawn	female
Evalyn	female
Felipa	female
Cruz	male
Brianne	female
Jenise	female
Tangela	female
Kay	female
Marlyn	female
Reid	male
Renna	female
Thad	male
Lorri	female
Von	male
Gonzalo	male
Monserrate	female
Sirena	female
Cleveland	male
Starla	female
Chanelle	female
Un	female
Kristofer	male
Taryn	female
Tawana	female
Camilla	female
Ronda	female
Cliff	male
Tracee	female
Marla	female
Tianna	female
Christinia	female
Merissa	female
Antonetta	female
Emeline	female
Roseanna	female
Tori	female
Marlen	female
Elvira	female
Alan	male
Sueann	female
Jacquetta	female
Sharyl	female
Sharyn	female
Marketta	female
Desmond	male
Gaynelle	female
Quyen	female
Nedra	female
Freida	female
Arnoldo	male
Venice	female
Fernanda	female
Micah	male
Dina	female
Lianne	female
Fernande	female
Madie	female
Queen	female
Felix	male
Skye	female
Fernando	male
Lloyd	male
Dorcas	female
Jenee	female
Anderson	male
Tamika	female
Chauncey	male
Criselda	female
Luba	female
Modesta	female
Katelynn	female
Doyle	male
Ricki	female
Rudolph	male
Jamika	female
Lecia	female
Lashay	female
Thomas	male
Jeffie	female
Tracey	female
Milly	female
January	female
Candy	female
Delois	female
Lulu	female
Karlyn	female
Ming	female
Werner	male
Cuc	female
Darcey	female
Lanita	female
Lula	female
Krystal	female
Clarita	female
Manuela	female
Serafina	female
Paul	male
Tereasa	female
Kimber	female
Ginette	female
April	female
Charleen	female
Tanner	male
Genevive	female
Delfina	female
Kimbery	female
Terrilyn	female
Tajuana	female
Dustin	male
Natashia	female
Edwardo	male
Precious	female
Anette	female
Beulah	female
Tanika	female
Mindy	female
Dong	male
Serena	female
Kraig	male
Lupe	female
Aurora	female
Kary	female
Shonna	female
Jaye	female
Aurore	female
Asha	female
Rolanda	female
Lashawn	female
Ruby	female
Larae	female
Rolande	female
Vanetta	female
Marylynn	female
Michiko	female
Bert	male
Alec	male
Marine	female
Abel	male
Rolando	male
Malik	male
Pete	male
Roxie	female
Mitch	male
Elizebeth	female
Blythe	female
Dan	male
Jeniffer	female
Yessenia	female
Rosanne	female
Miyoko	female
Janyce	female
Forest	male
Reena	female
Katerine	female
Jean	female
Donn	male
Jeannie	female
Keesha	female
Mose	male
Monica	female
Bernardine	female
Gennie	female
Taneka	female
Russell	male
Bernardina	female
Alonso	male
Season	female
Brad	male
Suzann	female
Layla	female
Camie	female
Camille	female
Hassan	male
Emelina	female
Marco	male
Kellye	female
Emmitt	male
Harry	male
Julienne	female
Melida	female
Ula	female
Mack	male
Abby	female
Quincy	male
Earline	female
Emile	male
Toccara	female
Hee	female
Stefani	female
Tyesha	female
Percy	male
Melody	female
Tifany	female
Stephany	female
Pasquale	male
Brigida	female
Elvera	female
Jovita	female
Shaneka	female
Meg	female
Emmett	male
Emily	female
Shawana	female
Glenda	female
Lars	male
Lene	female
Lena	female